Witherbark 위더바크 - 마른나무껍질 (부족)
타이드 미스트레스 - 해일여제
스파이틀래쉬 - 원한꼬리일족
와일드터스크 - 야생엄니
스톰 베이 - 폭풍해안
미스트윙 뿔 - 안개날개 뿔
팅크마스터 - 수석땜장이
Transponder - 응답장치
Tinkerer - 땜장이
아즈라이트 비늘 - 하늘빛 비늘 - Azure Scale
Blue Dragonflight - 블루 드래곤플라이트 - 푸른 용군단
레이크 멘나르 - 멘나르 호수
Flaxwhisker Front - 플렉스위스커 프런트 -> 수정 플렉스위스커 전초기지
Gyronautical Compass - 자이로나우티컬 컴퍼스
Gigno - 지노
Thorium Widget - 토륨 부품
Unstable Trigger - 유동성 제동장치
Caravan - 짐마차
Watch Paladin - 감시터 성기사
Deadwind Pass - 죽음의 고개
Sorrowguard keep - 슬픔의수호 요새
Quartermaster - 병참장교
Marsh Inkspewer - 늪지멀록 먹물쟁이
Marsh Murloc - 늪지멀록
Marsh Flesheater - 늪지멀록 청소부
Tirisfal Uplands - 티리스팔 고원
The Dead Fields - 죽음의 농장
Steepcliff Port - 가파른절벽 항구
Pesterhide Gnoll - 점박이 놀
Ragged Armband - 너덜너덜한 팔찌
Glenshire - 글렌샤이어
Deathguard - 데스가드 - 죽음의 경비병
Worgen - 워겐 - 늑대인간
Tirisclaw - 티리스클로우 - 검은발톱
Foulweald - 펄위드 - 썩은나무일족
Grovetender - 그로브텐더 - 숲지기
Wallowfin Murloc - 왈로핀 멀록 - 거친해안 멀록
Deckmaster - 갑판장
Remnant - 잔존세력
Booty Bay - 무법항
Ghostpaw - 유령발늑대
애쉬엔베일 - 잿빛 골짜기 - Ashenvale